查流水	__label__liushui
查询流水	__label__liushui
查询下流水信息	__label__liushui
我要查下流水	__label__liushui
帮我看下流水	__label__liushui
查询一下流水信息	__label__liushui
帮我查询下流水信息	__label__liushui
我上个月流水信息啥样	__label__liushui
看看上个月的流水	__label__liushui
查询上个月流水	__label__liushui
今年三月份流水信息	__label__liushui
查下大上个月的流水	__label__liushui
查询去年的流水信息	__label__liushui
帮我看看今年7月的流水	__label__liushui
我要查去年9月份的流水信息	__label__liushui
查一下10月流水情况	__label__liushui
流水信息给我看看	__label__liushui
查1月份的流水	__label__liushui
咨询下流水信息	__label__liushui
查2018年6月的流水	__label__liushui
查询下2019年12月的流水记录	__label__liushui
帮我看看我2017年九月份的流水吧	__label__liushui
2016年全年的流水查询	__label__liushui
我要看看我2015年的流水	__label__liushui
你会查询流水吗	__label__liushui
帮我查下流水记录吧	__label__liushui
转账	__label__zhuanzhang
转钱	__label__zhuanzhang
帮我转个钱吧	__label__zhuanzhang
我想要转钱	__label__zhuanzhang
转一笔钱给大刘	__label__zhuanzhang
转钱给小侯吧	__label__zhuanzhang
给老赵转钱200元	__label__zhuanzhang
帮我转一笔钱给娜姐	__label__zhuanzhang
帮我转账	__label__zhuanzhang
给我转账	__label__zhuanzhang
给小王转账	__label__zhuanzhang
我想转账给小张	__label__zhuanzhang
转一笔账	__label__zhuanzhang
转给赵四100元	__label__zhuanzhang
给孙总转账一百元	__label__zhuanzhang
我要给李丽转500块	__label__zhuanzhang
帮我给周同学转账	__label__zhuanzhang
给吴立转账一万	__label__zhuanzhang
转个账给郑女士	__label__zhuanzhang
给老王转账900吧	__label__zhuanzhang
转3000给小侯	__label__zhuanzhang
能帮我转个账吗	__label__zhuanzhang
给林总转账800	__label__zhuanzhang
我要给老师转钱	__label__zhuanzhang
转钱给我妈妈	__label__zhuanzhang
给我爸转个五万块吧	__label__zhuanzhang
转一笔钱给冯哥	__label__zhuanzhang
转账给杨叔二百	__label__zhuanzhang
你会转账吗	__label__zhuanzhang
你能帮我转账吗	__label__zhuanzhang
帮我转个账吧	__label__zhuanzhang
请年假	__label__nianjia
我想请个年假	__label__nianjia
帮我请个年假吧	__label__nianjia
办理年假	__label__nianjia
申请年假	__label__nianjia
我要办年假申请	__label__nianjia
我想请4.5到4.8的年假	__label__nianjia
申请5月20号到5月23号的年假	__label__nianjia
办理一月十日到十五日的年假	__label__nianjia
帮我请个11月7号到9号的年假吧	__label__nianjia
请个年假，明天到大后天	__label__nianjia
申请这个月20号到23号的年假	__label__nianjia
年假可以申请吗	__label__nianjia
下个月12号到18号的年假我要申请	__label__nianjia
办一下年假	__label__nianjia
办7月十六到20号的年假	__label__nianjia
申九月一号开始到六号结束的年假	__label__nianjia
办理年假，10月8号到10月11号	__label__nianjia
请帮我办理下12月22号到25号的年假申请	__label__nianjia
申请一下年假可以不	__label__nianjia
你是男是女	__label__other
你的生日是哪天	__label__other
你妈妈是谁	__label__other
你爸爸是谁	__label__other
你在哪里	__label__other
你会做什么	__label__other
你长什么样子	__label__other
你有什么爱好	__label__other
你有朋友吗	__label__other
你睡觉吗	__label__other
你是不是机器人	__label__other
你喜欢吃什么	__label__other
你几岁了	__label__other
你好聪明	__label__other
你觉得我长得帅吗	__label__other
我可以给你改个名字吗	__label__other
在吗	__label__other
你好	__label__other
你来自哪里	__label__other
你喜欢做什么	__label__other
